Columns: 30
Rows: 10
TileSize: 32
230111102323011110232301111023
450111104545011110454501111045
230111102323011110232301111023
450111104545011110454501111045
230000000000000000000000000023
450000000000000000000000000045
230111102323011110232301111023
450111104545011110454501111045
230111102323011110232301111023
450111104545011110454501111045