Columns: 10
Rows: 19
TileWidth: 96
TileHeight: 32
0000000000
0111111110
0000000000
0222002220
0000000000
0333003330
0000000000
0000440000
0000000000
0000000000
0000000000
0000000000
0000000000
0000000000
0000000000
0000000000
0000000000
0000000000
0000000000