Columns: 10
Rows: 19
TileWidth: 96
TileHeight: 32
0000000000
0555555550
0555555550
0000000000
0444444440
0444444440
0000000000
0333333330
0333333330
0000000000
0000000000
0000000000
0000000000
0000000000
0000000000
0000000000
0000000000
0000000000
0000000000