Columns: 10
Rows: 19
TileWidth: 96
TileHeight: 32
0000000000
0222222220
0222222220
0209009020
0200000020
0222002220
0000000000
0000000000
0000000000
0000000000
0000000000
0000000000
0000000000
0000000000
0000000000
0000000000
0000000000
0000000000
0000000000