Columns: 10
Rows: 19
TileWidth: 96
TileHeight: 32
0000000000
0555555550
0000660000
0494444440
0000660000
0333333930
0000660000
02=2222220
0000660000
0111111<10
0000000000
0000000000
0000000000
0000000000
0000000000
0000000000
0000000000
0000000000
0000000000