Columns: 10
Rows: 19
TileWidth: 96
TileHeight: 32
0000000000
0454545450
0545454540
0?545454?0
0000000000
0=545454=0
0545454540
0454545450
0000000000
0000000000
0000000000
0000000000
0000000000
0000000000
0000000000
0000000000
0000000000
0000000000
0000000000