Columns: 10
Rows: 19
TileWidth: 96
TileHeight: 32
0000000000
0000660000
0000440000
0004414000
0044144100
0441441440
0000220000
0?>0220=<0
0000000000
0000000000
0000000000
0000000000
0000000000
0000000000
0000000000
0000000000
0000000000
0000000000
0000000000