Columns: 10
Rows: 19
TileWidth: 96
TileHeight: 32
0000000000
0555111110
05;5666660
0555111110
0666666660
0111111110
0>00000000
0?00000000
0>00000000
0?00000000
0000000000
0000000000
0000000000
0000000000
0000000000
0000000000
0000000000
0000000000
0000000000