Columns: 10
Rows: 19
TileWidth: 96
TileHeight: 32
0000000000
01234432?0
0000000000
0000000000
0666006660
0>11001110
0000000000
0000000000
0000000000
0000000000
0000000000
0000000000
0000000000
0000000000
0000000000
0000000000
0000000000
0000000000
0000000000