Columns: 10
Rows: 19
TileWidth: 96
TileHeight: 32
0000000000
0666666660
0600000060
0600000060
0690000960
0600000060
0600000060
0606666060
0000000000
0000000000
0000000000
0000000000
0000000000
0000000000
0000000000
0000000000
0000000000
0000000000
0000000000