Columns: 10
Rows: 19
TileWidth: 96
TileHeight: 32
0000000000
0123443210
0000000000
0000000000
0666006660
0911001190
0000000000
0000000000
0000000000
0000000000
0000000000
0000000000
0000000000
0000000000
0000000000
0000000000
0000000000
0000000000
0000000000