Columns: 30
Rows: 19
TileSize: 32
000000000000000000000000000000
011234123412341231211341231120
042314312431124311233123434230
043321432143144323144431224330
041243412341234124144231234120
012341123443211233211411431230
023412134123412342312412312340
043214322143144323134431224320
031243213412433122423241123120
012341234112341231221341231230
031423143441341341314321213140
012341412342131231241344211230
041234123412334124114231234120
013412341341341344332212341340
043214321431441323134431224320
034123412341234231443123123410
043143124311243114213123434310
012341234123412312321341231230
000000000000000000000000000000